12 8 3
Villages.png
32
0 0 0 2 0 0 0 1
1 0 0 2 0 0 0 1
2 0 0 2 0 0 0 1
3 0 0 2 0 0 0 1
4 0 0 2 0 0 0 1
5 0 0 2 0 0 0 1
6 0 0 2 0 0 0 1
7 0 0 2 0 0 0 1
8 0 0 5 10 0 0 0
9 0 0 6 10 0 0 0
10 0 0 6 10 0 0 0
11 0 0 10 10 0 0 0
0 1 0 2 0 0 0 1
1 1 0 2 0 0 0 1
2 1 0 2 0 0 0 1
3 1 0 3 11 0 0 0
4 1 0 4 11 0 0 0
5 1 0 5 11 0 0 0
6 1 0 2 0 0 0 1
7 1 0 10 6 0 0 1
8 1 0 8 10 0 0 0
9 1 0 9 10 0 0 0
10 1 0 9 10 0 0 0
11 1 0 10 10 0 0 0
0 2 0 2 0 0 0 1
1 2 0 2 0 0 0 1
1 2 1 26 0 0 1 1
2 2 0 2 0 0 0 1
3 2 0 6 11 0 0 0
4 2 0 7 11 0 0 0
5 2 0 8 11 0 0 0
6 2 0 2 0 0 0 1
7 2 0 10 6 0 0 1
8 2 0 11 6 0 0 0
9 2 0 13 6 0 0 0
10 2 0 14 6 0 0 0
11 2 0 13 6 0 0 0
0 3 0 2 0 0 0 1
1 3 0 13 1 0 0 0
2 3 0 2 0 0 0 1
3 3 0 9 11 0 0 0
4 3 0 6 1 0 0 0
5 3 0 10 11 0 0 0
6 3 0 2 0 0 0 1
7 3 0 10 6 0 0 1
8 3 0 14 5 0 0 0
9 3 0 12 5 0 0 1
10 3 0 13 5 0 0 0
11 3 0 14 5 0 0 0
0 4 0 2 0 0 0 1
1 4 0 2 0 0 0 1
2 4 0 2 0 0 0 1
3 4 0 27 5 0 0 0
4 4 0 0 11 0 0 0
5 4 0 28 5 0 0 0
6 4 0 2 0 0 0 1
7 4 0 10 6 0 0 1
8 4 0 10 6 0 0 1
9 4 0 10 6 0 0 1
10 4 0 10 6 0 0 1
11 4 0 10 6 0 0 1
0 5 0 2 0 0 0 1
1 5 0 2 0 0 0 1
2 5 0 2 0 0 0 1
3 5 0 2 0 0 0 1
4 5 0 2 0 0 0 1
5 5 0 2 0 0 0 1
6 5 0 2 0 0 0 1
7 5 0 2 0 0 0 1
8 5 0 2 0 0 0 1
9 5 0 2 0 0 0 1
10 5 0 2 0 0 0 1
11 5 0 2 0 0 0 1
0 6 0 2 0 0 0 1
1 6 0 21 11 0 0 1
2 6 0 22 11 0 0 1
3 6 0 23 11 0 0 1
4 6 0 2 0 0 0 1
5 6 0 2 0 0 0 1
6 6 0 2 0 0 0 1
7 6 0 2 0 0 0 1
8 6 0 2 0 0 0 1
9 6 0 2 0 0 0 1
10 6 0 8 0 0 0 0
11 6 0 8 0 0 0 0
0 7 0 2 0 0 0 1
1 7 0 21 12 0 0 1
2 7 0 22 12 0 0 1
3 7 0 23 12 0 0 1
4 7 0 2 0 0 0 1
5 7 0 2 0 0 0 1
6 7 0 2 0 0 0 1
7 7 0 2 0 0 0 1
8 7 0 8 0 0 0 0
9 7 0 8 0 0 0 0
10 7 0 8 1 0 0 0
11 7 0 8 1 0 0 0
